aberration|a state or condition markedly different from the norm|
abhor|feel hatred or disgust toward|
acquiesce|agree or express agreement|
alacrity|liveliness and eagerness|
amiable|diffusing warmth and friendliness|
appease|make peace with|
arcane|requiring secret or mysterious knowledge|
avarice|reprehensible acquisitiveness; insatiable desire for wealth|
brazen|not held back by conventional ideas of behavior|
brusque|rudely abrupt or blunt in speech or manner|
cajole|influence or urge by gentle urging, caressing, or flattering|
callous|emotionally hardened|
candor|the quality of being honest and straightforward|
chide|scold or reprimand severely or angrily|
circumspect|careful to consider potential consequences and avoid risk|
coerce|cause to do through pressure or necessity|
coherent|marked by an orderly and consistent relation of parts|
complacency|the feeling you have when you are satisfied with yourself|
confidant|someone to whom private matters are told|
connive|form intrigues (for) in an underhand manner|
cumulative|increasing by successive addition|
debase|corrupt morally or by intemperance or sensuality|
decry|express strong disapproval of|
deferential|showing courteous regard for people's feelings|
demure|shy or modest, often in a playful or provocative way|
deride|treat or speak of with contempt|
despot|a cruel and oppressive dictator|
diligent|quietly and steadily persevering in detail or exactness|
elated|exultantly proud and joyful; in high spirits|
eloquent|expressing yourself readily, clearly, effectively|
embezzle|appropriate fraudulently to one's own use, This time, the amount of money allegedly embezzled was raised more than ten-fold and the charges made much more severe.|
empathy|understanding and entering into another's feelings|
enmity|a state of deep-seated ill-will|
erudite|having or showing profound knowledge|
extol|praise, glorify, or honor|
fabricate|make up something artificial or untrue|
flabbergasted|as if struck dumb with astonishment and surprise|
forsake|leave someone who needs or counts on you; leave in the lurch|
furtive|secret and sly|
gluttony|habitual eating to excess|
gratuitous|unnecessary and unwarranted|
haughty|having or showing arrogant superiority|
hypocrisy|pretending to have qualities or beliefs that you do not have|
impeccable|without error or flaw|
impertinent|improperly forward or bold|
impudent|improperly forward or bold|
indolent|disinclined to work or exertion|
inept|generally incompetent and ineffectual|
infamy|a state of extreme dishonor|
inhibit|limit the range or extent of|
innate|present at birth but not necessarily hereditary|
insatiable|impossible to fulfill, appease, or gratify|
insular|narrowly restricted in outlook or scope|
intrepid|invulnerable to fear or intimidation|
